xxxxxxxxxx
xaa1dd1aax
x11x11x11x
x        x
x  h  h  x
x   hh   x
x11x  x11x
xa  xx  dx
xaa 11 ddx
xxxxxxxxxx